Start of a transcript of:

DCproject
An Interactive Fiction by Sophia Ling
Release 1 / Serial number 241217 / Inform 7 v10.1.2 / D
Gate to the Osireion
The doorway to the temple stands before you, an unassuming looking side door. It was sturdy and made of good material, but seems to be lightly trafficked. It was even unguarded. (please add more historical info and revise this)

You can see a sun chariot here.

Inform 7 v10.1.2
Identification number: //898C0670-C5C4-47A2-99BB-FBE5F18E52C2//
Interpreter version 0.6.0 / VM 3.1.3
Rideable Vehicles version 3 by Graham Nelson

DCproject
An Interactive Fiction by Sophia Ling
Release 1 / Serial number 241217 / Inform 7 v10.1.2 / D

Gate to the Osireion
The doorway to the temple stands before you, an unassuming looking side door. It was sturdy and made of good material, but seems to be lightly trafficked. It was even unguarded. (please add more historical info and revise this)

You can see a sun chariot here.

Gate to the Osireion
The doorway to the temple stands before you, an unassuming looking side door. It was sturdy and made of good material, but seems to be lightly trafficked. It was even unguarded. (please add more historical info and revise this)

You can see a sun chariot here.

>2
I didn't understand that sentence.

>get on chariot
As you step onto the chariot, the serpents in front hiss joyfully, happy to see you again. From here you could choose to go to: 
  1: Thebes
  2: Memphis
  3: Avaris

>2
Memphis

>w
You can't go that way.

>e
You can't go that way.

>jn
I didn't understand that sentence.

>n
Avaris

>get on chariot
You can't see any such thing.

>1
I didn't understand that sentence.

>go to chariot
You quickly head towards your sun chariot. You've got somewhere to get to!

Transporter Room
You can see a sun chariot here.

>get off chariot
But you aren't on the sun chariot at the moment.

>clear
(the sun chariot)
It is fixed in place.

>eat
(the sun chariot)
That's plainly inedible.

>eat chariot
That's plainly inedible.

>boooooo
I didn't understand that sentence.

>kill myself
Violence isn't the answer to this one.

>kill chariot
Violence isn't the answer to this one.

>chop up chariot
I only understood you as far as wanting to chop up.

>chop chariot
Cutting it up would achieve little.

>take chariot
That's fixed in place.

>test
>--> The following tests are available:
'test me'

>test me
(Testing.)

>[1] get on chariot
As you step onto the chariot, the serpents in front hiss joyfully, happy to see you again. From here you could choose to go to: 
  1: Thebes
  2: Memphis
  3: Avaris

>[2] 0
0 is not a valid option. From here you could choose to go to: 
  1: Thebes
  2: Memphis
  3: Avaris

>[3] -1
-1 is not a valid option. From here you could choose to go to: 
  1: Thebes
  2: Memphis
  3: Avaris

>[4] 8
8 is not a valid option. From here you could choose to go to: 
  1: Thebes
  2: Memphis
  3: Avaris

>[5] 2
Memphis

>[6] look
Memphis

>[7] w
You can't go that way.

>[8] home
I didn't understand that sentence.

>[9] get on chariot
You can't see any such thing.

>[10] get off chariot
You can't see any such thing.

>[11] 3
I didn't understand that sentence.

* * *

>3
You can transport only from the transporter pad. From other places than the transporter room, you can HOME to your base ship, but not leap sideways to other locations.

>get on pad
The transporter beeps and glows amber as you step onto its surface. A moment later a hologram displays your options. From here you could choose to go to: 
  1: Region1
  2: Region2
  3: Region3

>5
5 is not a valid option. From here you could choose to go to: 
  1: Region1
  2: Region2
  3: Region3

>1
Region1

>home
Transporter Room
The transporter pad in the middle of the floor is currently dull blue: powered but unoccupied.

>get on pad
The transporter beeps and glows amber as you step onto its surface. A moment later a hologram displays your options. From here you could choose to go to: 
  1: Region1
  2: Region2
  3: Region3

>4
4 is not a valid option. From here you could choose to go to: 
  1: Region1
  2: Region2
  3: Region3

>3
Region3

>e
You can't go that way.

>w
You can't go that way.

* * *

>SCENES
Scene 'Entire Game' playing (for 0 mins now)
(Scene monitoring now switched on. Type "scenes off" to switch it off again.)

>test amarna
(first acquiring Osiris' head)
(Testing.)

>[1] say hi
(to Osiris' head)
There is no reply.

Your sun chariot is parked at Avaris-Marketplace, fiercely guarded by your pet serpents.

>[2] get on chariot
As you step onto the chariot, the serpents in front hiss joyfully, happy to see you again. From here you could choose to go to: 
  1: Avaris
  2: Busiris
  3: Heliopolis
  4: Memphis
  5: Oxyrhynchos
  6: Amarna
  7: Abydos
  8: Thebes
  9: Elephantine

>[3] 6
Workmen's Village
A dusty cluster of homes and workshops, bustling with activity. The air smells of clay and stone.

You can see a workman here.

[Scene 'Discovery' begins]
Your sun chariot is parked at the Workmen's Village, fiercely guarded by your pet serpents.

>takl to workman
I didn't understand that sentence.

>talk to workman
The workman gestures around. "This village," he says, "it's where the elite tombs nearby are prepared. Hard work, but someone's got to do it." He looks at you curiously. "What are you doing here, anyway? And good gods, are you pregnant?!"

[Scene 'Discovery' ends]
[Scene 'Acquisition' begins]

>talk to workman
The workman looks at you expectantly. "What are you doing here, anyway? And what's up with the stomach?"

>show head to workman
Hey! I don't know what your whole deal is, but here, it's good manners to keep body parts inside a body bag." He tosses you a body bag.

>talk to workman
The workman looks at you expectantly. "What are you doing here, anyway? And what's up with the stomach?"

>i
You are carrying:
  a body bag
  Osiris' head

* * *

>asd
I didn't understand that number.

>west
You can't go that way.

>get on chariot
As you step onto the chariot, the serpents in front hiss joyfully, happy to see you again. From here you could choose to go to: 
  1: Thebes
  2: Memphis
  3: Avaris

>1
I didn't understand that sentence.

>1
I didn't understand that sentence.

* * *

>bait
What do you want to bait?

>bait bait
(first taking the bait)
You can't bait that.

>bait knife
(first taking the knife)
You can't bait that.

* * *

>bait
What do you want to bait?

>bait fishing rod
(first taking the fishing rod)
What are you gonna bait it with? Yourself?

>bait me
(first taking yourself)
You are always self-possessed.

>bait knife
(first taking the knife)
What are you gonna bait it with? Yourself?

* * *

>bait fishing rod
(first taking the fishing rod)
What are you gonna bait it with? Yourself?

>take all
bait: Taken.
knife: Taken.

>bait fishing rod
You attach the bait carefully to the fishing rod.

>bait
What do you want to bait?

>bait fishing rod
More is not always better.

>i
You are carrying:
  a knife
  a fishing rod

* * *

>bait fishing rod
You don't have that.

>take fishing rod
Taken.

>bait fishing rod
What are you gonna bait it with? Yourself?

>bait fishing rod with bait
I only understood you as far as wanting to bait the fishing rod.

>take all
bait: Taken.
knife: not yet

>i
You are carrying:
  some bait
  a fishing rod

>bait fishing rod
You attach the bait carefully to the fishing rod.

>i
You are carrying:
  a fishing rod with bait

>e
Nile Riverbank
You are at the bank of the Nile.

You can see a catfish here.

>fish
You missed the fish!

>fish
You missed the fish!

>fish
You have caught the catfish! Sadly, you can only carry one at a time.

>fish
You missed the fish!

>x rod
You see nothing special about the fishing rod with bait.

* * *

>bait knife
(first taking the knife)
not yet

>i
You are carrying nothing.

* * *

>chant
I didn't understand that sentence.

* * *

>chanting
I didn't understand that sentence.

>chant
I didn't understand that sentence.

>your mom is gay
oh yeah she is

* * *

>chariot
I didn't understand that sentence.

>enter chariot
You can't see any such thing.

* * *

>ds
I didn't understand that sentence.

>1
I didn't understand that sentence.

>get on chariot
As you step onto the chariot, the serpents in front hiss joyfully, happy to see you again. From here you could choose to go to: 
  1: Thebes
  2: Memphis
  3: Avaris

>1
You quickly head towards your sun chariot. You've got somewhere to get to!

Thebes

* * *

>e
Nile Riverbank
You are at the bank of the Nile.

You can see a catfish here.

>w
Oxyrhynchus
You are in Oxyrhynchus, home of the medjed elephantfish. A little further east is the riverbank of the Nile.

You can see some bait, a fishing rod and a knife here.

>take all
bait: Taken.
fishing rod: Taken.
knife: Taken.

>e
Nile Riverbank
You are at the bank of the Nile.

You can see a catfish here.

>fish
You won't catch much without bait on the hook.

>fish
You won't catch much without bait on the hook.

>bait rod
You attach the bait carefully to the fishing rod.

>fish
You cast your fishing rod out with a strong throw...

You missed the fish!

>fish
You cast your fishing rod out with a strong throw...

You have caught the catfish! Sadly, you can only carry one at a time.

>fish
You already have a fish in your posession. Don't be so greedy.

>x fish
You see nothing special about the catfish.

>cut fish
You carefully cut open the catfish with the knife. Inside its stomach, you find Osiris" penis!

>cut fish
You carefully cut open the catfish with the knife. Inside its stomach, you find Osiris" penis!

>x fish
You see nothing special about the catfish.

* * *

>eat catfish
You look at it with immense distrust. It just looks so awfully... fishy... Better not.

>look
Transporter Room
You can see a sun chariot, Osiris' head and a catfish here.

>take catfish
Taken.

>i
You are carrying:
  a catfish

>eat catfish
You look at it with immense distrust. It just looks so awfully... fishy... Better not.

>i
You are carrying:
  a catfish

* * *

>eat fishing rod
That's plainly inedible.

>eat bait
Edible, sure, but you're no fish.

>eat knife
That's plainly inedible.

>e
Nile Riverbank
You are at the bank of the Nile.

You can see a catfish here.

>fish
You've got nothing to fish with. Your hands won't suffice, unfortunately.

>i
You are carrying nothing.

>w
Oxyrhynchus
You are in Oxyrhynchus, home of the medjed elephantfish.

You can see some bait, a fishing rod and a knife here.

>take all
bait: Taken.
fishing rod: Taken.
knife: Taken.

>fish
You won't catch much without bait on the hook.

>e
Nile Riverbank
You are at the bank of the Nile.

You can see a catfish here.

* * *

>enter door
(first opening the stone door)
It seems to be locked.

Your sun chariot is parked at the Gate to the Oseiron, fiercely guarded by your pet serpents.

>enter door
(first opening the stone door)
It seems to be locked.

* * *

>enter sun chariot
You can't see any such thing.

>x room
You can't see any such thing.

>x
What do you want to examine?

>scene
You can't see any such thing.

>x marketplace
You can't see any such thing.

* * *

>fish
You've got nothing to fish with. Your hands won't suffice, unfortunately.

I beg your pardon?

I beg your pardon?

* * *

>fish
You've got nothing to fish with. Your hands won't suffice, unfortunately.

>fish all
I only understood you as far as wanting to fish.

>take all
bait: Taken.
fishing rod: Taken.
knife: Taken.

* * *

>e
Nile Riverbank
You are at the bank of the Nile.

You can see a catfish here.

>fish
You must supply a noun.

* * *

>fish
You've got nothing to fish with. Your hands won't suffice, unfortunately.

>fish for potato
I only understood you as far as wanting to fish.

>fish knife
I only understood you as far as wanting to fish.

* * *

>fish
You've got nothing to fish with. Your hands won't suffice, unfortunately.

>fish rod
I only understood you as far as wanting to fish.

* * *

>fish
You've got nothing to fish with. Your hands won't suffice, unfortunately.

>take all
bait: Taken.
fishing rod: Taken.
knife: Taken.

* * *

>bait rod
You attach the bait carefully to the fishing rod.

>bait
What do you want to bait?

>bait knife
You can't bait that.

>bait hook
You can't see any such thing.

>bait rod
More is not always better.

>i
You are carrying:
  a knife
  a fishing rod with bait

>fish
This is not a viable place to be fishing.

>e
Nile Riverbank
You are at the bank of the Nile.

You can see a catfish here.

* * *

>fish
You've got nothing to fish with. Your hands won't suffice, unfortunately.

>take rod
Taken.

>fish
You won't catch much without bait on the hook.

>take bait
Taken.

>fish
You won't catch much without bait on the hook.

* * *

>bait rod
You attach the bait carefully to the fishing rod.

>fish
This is not a viable place to be fishing.

* * *

>e
Nile Riverbank
You are at the bank of the Nile.

You can see a catfish here.

>fish
You cast your fishing rod out with a strong throw...

You missed the fish!

>fish
You cast your fishing rod out with a strong throw...

You missed the fish!

* * *

>get on chariot
As you step onto the chariot, the serpents in front hiss joyfully, happy to see you again. From here you could choose to go to: 
  1: Avaris
  2: Busiris
  3: Heliopolis
  4: Memphis
  5: Oxyrhynchos
  6: Amarna
  7: Abydos
  8: Thebes
  9: Elephantine

>4
Nile Riverbank
You are at the bank of the Nile.

You can see a fishing pole, Fish-food, a knife and a catfish here.

>take catfish
The catfish is swimming freely in the Nile. Maybe you could try fishing for it.

>take fish
You pick up the fish food. Maybe it can be used as bait on the fishing pole.

>take pole
Taken.

>i
You are carrying:
  a fishing pole

>fish
It probably won't be very productive without any bait.

You cast the baited fishing pole into the river and wait patiently...
After a few moments, you feel a tug and pull up a large catfish!

>i
You are carrying:
  a catfish
  a fishing pole

>eat fish
That's plainly inedible.

>eat catfish
You look at it with immense distrust. It just looks so awfully... fishy... Better not.

>x
What do you want to examine?

* * *

>scene
You can't see any such thing.

>x room
You can't see any such thing.

>x pole
A sturdy fishing pole, but it could use some bait.

>take food
You attach the fish food to the fishing pole as bait.

* * *

>4
Nile Riverbank
You are at the bank of the Nile.

You can see a fishing pole, Fish-food, a knife and a catfish here.

>take fish-food
Taken.

>take fishing pole
Taken.

* * *

>get on chariot
As you step onto the chariot, the serpents in front hiss joyfully, happy to see you again. From here you could choose to go to: 
  1: Avaris
  2: Busiris
  3: Heliopolis
  4: Memphis
  5: Oxyrhynchos
  6: Amarna
  7: Abydos
  8: Thebes
  9: Elephantine

>5
Oxyrhynchos
You are in Oxyrhynchos, home of the medjed elephantfish. A little further east is the riverbank of the Nile.

You can see some bait, a fishing rod and a knife here.

>take all
bait: Taken.
fishing rod: Taken.
knife: Taken.

>go east
Nile Riverbank
You are at the bank of the Nile.

You can see a catfish here.

>fish
You won't catch much without bait on the hook.

* * *

>bait rod
You attach the bait carefully to the fishing rod.

>fish
You cast your fishing rod out with a strong throw...

You have caught the catfish!

* * *

>get on chariot
As you step onto the chariot, the serpents in front hiss joyfully, happy to see you again. From here you could choose to go to: 
  1: Avaris
  2: Busiris
  3: Heliopolis
  4: Memphis
  5: Oxyrhynchos
  6: Amarna
  7: Abydos
  8: Thebes
  9: Elephantine

>6
Outside the Walled Village
more description here

Your sun chariot is parked at Outside the Walled Village, fiercely guarded by your pet serpents.

>e
You can't go that way.

>n
Workmen's Village
A dusty cluster of homes and workshops, bustling with activity.

You can see a workman here.

>s
Outside the Walled Village
more description here

You can see a sun chariot here.

>enter Workmen's Village
You can't see any such thing.

* * *

>get on chariot
As you step onto the chariot, the serpents in front hiss joyfully, happy to see you again. From here you could choose to go to: 
  1: Avaris
  2: Busiris
  3: Heliopolis
  4: Memphis
  5: Oxyrhynchos
  6: Amarna
  7: Abydos
  8: Thebes
  9: Elephantine

>8
Temple of Tawosret
The Temple of Tawosret stands here.

Your sun chariot is parked at the Temple of Tawosret, fiercely guarded by your pet serpents.

* * *

>get on chariot
As you step onto the chariot, the serpents in front hiss joyfully, happy to see you again. From here you could choose to go to: 
  1: Avaris
  2: Busiris
  3: Heliopolis
  4: Memphis
  5: Oxyrhynchos
  6: Amarna
  7: Abydos
  8: Thebes
  9: Elephantine

>board chariot
I didn't understand that number.

>exit
You get off the sun chariot.

Transporter Room
You can see a sun chariot and Osiris' head here.

>board chariot
I didn't understand that sentence.

>get on chariot
As you step onto the chariot, the serpents in front hiss joyfully, happy to see you again. From here you could choose to go to: 
  1: Avaris
  2: Busiris
  3: Heliopolis
  4: Memphis
  5: Oxyrhynchos
  6: Amarna
  7: Abydos
  8: Thebes
  9: Elephantine

* * *

>5
Oxyrhynchos
You are in Oxyrhynchos, home of the medjed elephantfish. A little further east is the riverbank of the Nile.

You can see some bait, a fishing rod and a knife here.

>i
You are carrying nothing.

>take all
bait: Taken.
fishing rod: Taken.
knife: Taken.

* * *

>get on chariot
As you step onto the chariot, the serpents in front hiss joyfully, happy to see you again. From here you could choose to go to: 
  1: Avaris
  2: Busiris
  3: Heliopolis
  4: Memphis
  5: Oxyrhynchos
  6: Amarna
  7: Abydos
  8: Thebes
  9: Elephantine

>get on chariot
You can't see any such thing.

>hi
I didn't understand that sentence.

>say hi
(to yourself)
There is no reply.

Your sun chariot is parked in Avaris-Marketplace, fiercely guarded by your pet serpents.

* * *

>get on pad
You can't see any such thing.

>0
0 is not a valid option. From here you could choose to go to: 
  1: Oodville
  2: Midnight

>1
Oodville

>look
Oodville

>w
You can't go that way.

>home
Transporter Room
The transporter pad in the middle of the floor is currently dull blue: powered but unoccupied.

>get on pad
The transporter beeps and glows amber as you step onto its surface. A moment later a hologram displays your options. From here you could choose to go to: 
  1: Oodville
  2: Midnight

>0
0 is not a valid option. From here you could choose to go to: 
  1: Oodville
  2: Midnight

>-1
-1 is not a valid option. From here you could choose to go to: 
  1: Oodville
  2: Midnight

>8
8 is not a valid option. From here you could choose to go to: 
  1: Oodville
  2: Midnight

>2
Midnight

>look
Midnight

>w
Diamond City

>home
Transporter Room
The transporter pad in the middle of the floor is currently dull blue: powered but unoccupied.

>get on pad
The transporter beeps and glows amber as you step onto its surface. A moment later a hologram displays your options. From here you could choose to go to: 
  1: Oodville
  2: Midnight
  3: Diamond City

>get off pad
You get off the transporter pad.

Transporter Room
The transporter pad in the middle of the floor is currently dull blue: powered but unoccupied.

>1
You can transport only from the transporter pad. From other places than the transporter room, you can HOME to your base ship, but not leap sideways to other locations.

* * *

>get on pad
You can't see any such thing.

>2
Region2

>w
Region3

>5
You can transport only from the transporter pad. From other places than the transporter room, you can HOME to your base ship, but not leap sideways to other locations.

>4
You can transport only from the transporter pad. From other places than the transporter room, you can HOME to your base ship, but not leap sideways to other locations.

>2
You can transport only from the transporter pad. From other places than the transporter room, you can HOME to your base ship, but not leap sideways to other locations.

>1
You can transport only from the transporter pad. From other places than the transporter room, you can HOME to your base ship, but not leap sideways to other locations.

* * *

>get on pad
You can't see any such thing.

>3
3 is not a valid option. From here you could choose to go to: 
  1: Region1
  2: Region2

>1
Region1

* * *

>get on pad
You can't see any such thing.

>eat
(the transporter pad)
That's plainly inedible.

>4
4 is not a valid option. From here you could choose to go to: 
  1: Region1
  2: Region2

>-1
-1 is not a valid option. From here you could choose to go to: 
  1: Region1
  2: Region2

>2
Region2

* * *

>w
Region3

>3
You can transport only from the transporter pad. From other places than the transporter room, you can HOME to your base ship, but not leap sideways to other locations.

3 is not a valid option. From here you could choose to go to: 
  1: Region1
  2: Region2

* * *

>get on pad
You can't see any such thing.

>get on chariot
The transporter beeps and glows amber as you step onto its surface. A moment later a hologram displays your options. From here you could choose to go to: 
  1: Region 1
  2: Region 2
  3: Region 3

>5
5 is not a valid option. From here you could choose to go to: 
  1: Region 1
  2: Region 2
  3: Region 3

>3
Region 3

>e
Region2

>chariot
Transporter Room
The sun chariot in the middle of the floor is currently dull blue: powered but unoccupied.

* * *

>go to chariot
You're already here!

>potato
I didn't understand that number.

>1
You can get there only with the sun chariot. From other places than the transporter room, you can HOME to your base ship, but not leap sideways to other locations.

>potato
I didn't understand that number.

>boop
I didn't understand that number.

>eat
(the sun chariot)
That's plainly inedible.

>poof
I didn't understand that number.

* * *

>home
I didn't understand that number.

>chariot
You're already here!

>go to chariot
You can't see any such thing.

>i
You are carrying nothing.

* * *

>home
I didn't understand that number.

>home
I didn't understand that number.

* * *

>chariot
You're already here!

>get on chariot
As you step onto the chariot, the serpents in front hiss joyfully, happy to see you again. From here you could choose to go to: 
  1: Thebes
  2: Memphis
  3: Avaris

>1
Thebes

>chariot
Transporter Room
You quickly head towards your sun chariot. You've got somewhere to get to!

* * *

>kill catfish
Violence isn't the answer to this one.

* * *

>say hi to catfish
There is no reply.

* * *

>take catfish
Taken.

>take catfish
You already have that.

* * *

>ls
I didn't understand that sentence.

>test fish
(first moving to Oxyrhynchus)

(Testing.)

>[1] take all
bait: Taken.
fishing rod: Taken.
knife: Taken.

>[2] bait rod
You attach the bait carefully to the fishing rod.

>[3] e

Nile Riverbank
You are at the bank of the Nile.

You can see a catfish here.

>[4] fish
You cast your fishing rod out with a strong throw...

You missed the fish!

>fish
You cast your fishing rod out with a strong throw...

You missed the fish!

>x fish
It's a catfish... I wonder if that has any significance?

>x fish
It's a catfish... I wonder if that has any significance?

>fish
You cast your fishing rod out with a strong throw...

You have caught the catfish!

* * *

>n
You can't go that way.

>s
Avaris-Marketplace
Your sun chariot is parked in Avaris-Marketplace, fiercely guarded by your pet serpents.

>get on chariot
As you step onto the chariot, the serpents in front hiss joyfully, happy to see you again. From here you could choose to go to: 
  1: Avaris
  2: Busiris
  3: Heliopolis
  4: Memphis
  5: Oxyrhynchos
  6: Amarna
  7: Abydos
  8: Thebes
  9: Elephantine

>exit chariot
I only understood you as far as wanting to exit.

>exit
You get off the sun chariot.

Avaris-Marketplace
You can see a sun chariot here.

>enter chariot
As you step onto the chariot, the serpents in front hiss joyfully, happy to see you again. From here you could choose to go to: 
  1: Avaris
  2: Busiris
  3: Heliopolis
  4: Memphis
  5: Oxyrhynchos
  6: Amarna
  7: Abydos
  8: Thebes
  9: Elephantine

>2
Busiris-Marketplace

>enter chariot
As you step onto the chariot, the serpents in front hiss joyfully, happy to see you again. From here you could choose to go to: 
  1: Avaris
  2: Busiris
  3: Heliopolis
  4: Memphis
  5: Oxyrhynchos
  6: Amarna
  7: Abydos
  8: Thebes
  9: Elephantine

* * *

>n
You can't go that way.

>x book
It is entitled Why Not To Take A Stuffed Bear, A Chocolate Cookie And A Book To The Moon.

* * *

>s
(first opening the stone door)
It seems to be locked.

Your sun chariot is parked at the Gate to the Oseiron, fiercely guarded by your pet serpents.

>enter chariot
As you step onto the chariot, the serpents in front hiss joyfully, happy to see you again. From here you could choose to go to: 
  1: Avaris
  2: Busiris
  3: Heliopolis
  4: Memphis
  5: Oxyrhynchos
  6: Amarna
  7: Abydos
  8: Thebes
  9: Elephantine

Your sun chariot is parked in Avaris-Marketplace, fiercely guarded by your pet serpents.

>9
Elephantine-Marketplace
Your sun chariot is parked in Elephantine-Marketplace, fiercely guarded by your pet serpents.

* * *

>s
(first opening the stone door)
It seems to be locked.

Your sun chariot is parked at the Gate to the Oseiron, fiercely guarded by your pet serpents.

>test amarna
(first acquiring Osiris' head)
(Testing.)

>[1] say hi
(to Osiris' head)
There is no reply.

>[2] get on chariot
As you step onto the chariot, the serpents in front hiss joyfully, happy to see you again. From here you could choose to go to: 
  1: Avaris
  2: Busiris
  3: Heliopolis
  4: Memphis
  5: Oxyrhynchos
  6: Amarna
  7: Abydos
  8: Thebes
  9: Elephantine

>[3] 6
Workmen's Village
A dusty cluster of homes and workshops, bustling with activity. The air smells of clay and stone.

You can see a workman here.

Your sun chariot is parked at the Workmen's Village, fiercely guarded by your pet serpents.

>s
Outside the Walled Village
You can see an oxcart here.

>get on oxcart
You mount the oxcart.

>e
You can't go that way.

>w
Ruined City (on the oxcart)
This glorious city, once the capital of Egypt, is nothing but ruins and foundations. In the distance, to the north, you see a small standing structure, sticking out like a sore thumb amongst the desolation.

>e
Outside the Walled Village (on the oxcart)

>get off cart
You can't see any such thing.

>get off oxcart
You dismount the oxcart.

Outside the Walled Village
You can see an oxcart here.

>w
Ruined City
This glorious city, once the capital of Egypt, is nothing but ruins and foundations. In the distance, to the north, you see a small standing structure, sticking out like a sore thumb amongst the desolation.

* * *

>say bi
(to yourself)
There is no reply.

Your sun chariot is parked at Avaris-Marketplace, fiercely guarded by your pet serpents.

* * *

>say hi
(to the stone door)
Nothing happens. Perhaps that is not the correct answer.

>enter chaiot
You can't see any such thing.

>enter chariot
As you step onto the chariot, the serpents in front hiss joyfully, happy to see you again. From here you could choose to go to: 
  1: Avaris
  2: Busiris
  3: Heliopolis
  4: Memphis
  5: Oxyrhynchos
  6: Amarna
  7: Abydos
  8: Thebes
  9: Elephantine

Your sun chariot is parked at Avaris-Marketplace, fiercely guarded by your pet serpents.

>7
Abydos-Marketplace
Your sun chariot is parked at Abydos-Marketplace, fiercely guarded by your pet serpents.

* * *

>say hi
(to the stone door)
Nothing happens. Perhaps that is not the correct answer.

>enter chariot
As you step onto the chariot, the serpents in front hiss joyfully, happy to see you again. From here you could choose to go to: 
  1: Avaris
  2: Busiris
  3: Heliopolis
  4: Memphis
  5: Oxyrhynchos
  6: Amarna
  7: Abydos
  8: Thebes
  9: Elephantine

Your sun chariot is parked at Avaris-Marketplace, fiercely guarded by your pet serpents.

* * *

>say hi
(to yourself)
There is no reply.

Your sun chariot is parked at Abydos-Marketplace, fiercely guarded by your pet serpents.

>n
Gate to the Oseiron

>x self
As good-looking as ever.

* * *

>say hi
(to the stone door)
Nothing happens. Perhaps that is not the correct answer.

>enter door
(first opening the stone door)
It seems to be locked.

>enter oseiron
You can't see any such thing.

>enter building
You can't see any such thing.

>enter temple
You can't see any such thing.

>enter door
(first opening the stone door)
It seems to be locked.

>x door
The heavy stone door is engraved with an ancient riddle: 
 "I am yesterday, veiled in shadows. 
 I am tomorrw, cloaked in flames. 
 A union of gods, a cycle complete."

>sun
I didn't understand that sentence.

>answer sun
(to the stone door)
As you speak the word "stone door," the massive stone door grinds open, revealing a long narrow passa

>enter door
descending passage
A long descending passage. Down south is a great hall. North is the gate.

>s
Great Hall
South is a small chamber. North is the long descending passage.

>s
Southern Chamber
The small chamber contains... something? North is the great hall

>n
Great Hall
South is a small chamber. North is the long descending passage.

>n
descending passage
A long descending passage. Down south is a great hall. North is the gate.

>s
Great Hall
South is a small chamber. North is the long descending passage.

>e
First Transverse Chamber

>e
Doorway to the Oseiron
To your east you see the central hall, grand and collonaded. However, surrounding the entire central hall island is a moat, preventing you from continuing through.

You can see a sun disk key here.

>e
You approach the edge of the moat, but there is no way across. The waters churn ominously, as if warning you to stay back.

>e
You approach the edge of the moat, but there is no way across. The waters churn ominously, as if warning you to stay back.

>take key
Taken.

>e
The golden sun disk in your possession begins to glow brightly, and a radiant bridge of light forms across the dark waters. With the way now open, you step forward.

Central Nave
You stand in the middle of the columns lining the central nave and look around. Surrounding you are 17 small cells. Most of them are shrouded in darkness and you could barely see inside, but one directly east of you seems to lead out to a bigger chamber. The doorway back to the first transverse chamber is to your west.

>e
Tomb of Osiris
You can see Osiris' head here.

* * *

>say hi
(to the stone door)
Nothing happens. Perhaps that is not the correct answer.

>get on chariot
As you step onto the chariot, the serpents in front hiss joyfully, happy to see you again. From here you could choose to go to: 
  1: Avaris
  2: Busiris
  3: Heliopolis
  4: Memphis
  5: Oxyrhynchos
  6: Amarna
  7: Abydos
  8: Thebes
  9: Elephantine

Your sun chariot is parked at Avaris-Marketplace, fiercely guarded by your pet serpents.

>6
Workmen's Village
A dusty cluster of homes and workshops, bustling with activity. The air smells of clay and stone.

You can see a workman here.

Your sun chariot is parked at the Workmen's Village, fiercely guarded by your pet serpents.

>SCENES
Scene 'Entire Game' playing (for 3 mins now)
Scene 'Discovery' playing (for 1 mins now)
(Scene monitoring now switched on. Type "scenes off" to switch it off again.)

>talk to workman
The workman gestures around. "This village," he says, "it's where the elite tombs nearby are prepared. Hard work, but someone's got to do it." He looks at you curiously. "What are you doing here, anyway? And good gods, are you pregnant?!"

[Scene 'Discovery' ends]
[Scene 'Acquisition' begins]
Your sun chariot is parked at the Workmen's Village, fiercely guarded by your pet serpents.

* * *

>say hi
(to the stone door)
Nothing happens. Perhaps that is not the correct answer.

>say bi
(to the stone door)
Nothing happens. Perhaps that is not the correct answer.

>answer sun
(to the stone door)
As you speak the word "sun," the massive stone door grinds open, revealing a long narrow passage.

* * *

>say hi to head
There is no reply.

* * *

>say saying some spell
(to yourself)
There is no reply.

>say hello
(to yourself)
There is no reply.

>say hello to head
You can only do that to something animate.

* * *

>say sun
(to the stone door)
As you speak the word "sun," the massive stone door grinds open, revealing a long narrow passage.

>x
(the sun chariot)
You see nothing special about the sun chariot.

>look
Gate to the Osireion
The doorway to the temple stands before you, an unassuming looking side door. It was sturdy and made of good material, but seems to be lightly trafficked. It was even unguarded. (please add more historical info and revise this)

You can see a sun chariot here.

>enter doorway
You can't see any such thing.

>enter door
descending passage
A long descending passage. Down south is a great hall. North is the gate.

>s
Great Hall
South is a small chamber. North is the long descending passage. East is the first transverse chamber.

>e
First Transverse Chamber

>e
Doorway to the Osireion
To your east you see the central hall, grand and collonaded. However, surrounding the entire central hall island is a moat, preventing you from continuing through.

A moat surrounds the entire central nave.

You can also see a sun disk key here.

* * *

>sorry
Oh, don't apologise.

>boop
I didn't understand that sentence.

* * *

>sun
I didn't understand that sentence.

>say sun
(to the stone door)
As you speak the word "sun," the massive stone door grinds open, revealing a long narrow passage.

>e
You can't go that way.

>n
You can't go that way.

>w
You can't go that way.

>s
descending passage
A long descending passage. Down south is a great hall. North is the gate.

>e
You can't go that way.

>s
Great Hall
South is a small chamber. North is the long descending passage. East is the first transverse chamber.

>e
First Transverse Chamber
To your east you see the central hall, grand and collonaded. However, surrounding the entire central hall island is a moat, preventing you from continuing through.

A moat surrounds the entire central nave.

You can also see a sun disk key here.

>w
Great Hall
South is a small chamber. North is the long descending passage. East is the first transverse chamber.

>s
South Chamber
The small chamber contains... something? North is the great hall. Mention the things in the room in this description of the room. player can examine for more details.

You can see a faience ankh, a bundle of dried thyme, an ostracon, some pottery jars, a wooden plank and some knick-knacks here.

>take plank
Taken.

>n
Great Hall
South is a small chamber. North is the long descending passage. East is the first transverse chamber.

>e
First Transverse Chamber
To your east you see the central hall, grand and collonaded. However, surrounding the entire central hall island is a moat, preventing you from continuing through.

A moat surrounds the entire central nave.

You can also see a sun disk key here.

>e
Nope.

>e
Nope.

I beg your pardon?

* * *

>take all
bait: Taken.
fishing rod: Taken.
knife: Taken.

>bait rod
You attach the bait carefully to the fishing rod.

>e
Nile Riverbank
You are at the bank of the Nile.

You can see a catfish here.

>fish
You cast your fishing rod out with a strong throw...

You have caught the catfish!

>fish
You cast your fishing rod out with a strong throw...

You missed the fish!

>fish
You cast your fishing rod out with a strong throw...

You have caught the catfish!

>fish
You already have a fish in your posession. Don't be so greedy.

>i
You are carrying:
  a catfish
  a knife
  a fishing rod with bait

>cut catfish
You slash the catfish with the knife.

Visible within is Osiris' penis.

>take penis
There's no penis here to take.

* * *

>fish
You cast your fishing rod out with a strong throw...

You have caught the catfish!

>x fish
It's a catfish... I wonder if that has any significance?

>x knife
You see nothing special about the knife.

>cut knie
You can't see any such thing.

>cut knife
You slash the knife with the knife.

>x knife
You see nothing special about the knife.

You see one rip in the knife.

>cut knife
You slash the knife with the knife.

>x knife
You see nothing special about the knife.

You see two rips in the knife.

>i
You are carrying:
  a catfish
  a knife
  a fishing rod

>cut fish
You slash the catfish with the knife.

Visible within is Osiris' penis.

>x fish
It's a catfish... I wonder if that has any significance?

You see one rip in the catfish, revealing Osiris' penis.

>take penis
Taken.

>ls
That's not a verb I recognise.

>i
You are carrying:
  Osiris' penis
  a catfish
  a knife
  a fishing rod

* * *

>e
Nile Riverbank
You are at the bank of the Nile.

You can see a catfish here.

>take penis
You can't see any such thing.

>take fish
The catfish is swimming freely in the Nile. Maybe you could try fishing for it.

>ls
That's not a verb I recognise.

>fish
You cast your fishing rod out with a strong throw...

You missed the fish!

>fish
You won't catch much without bait on the hook.

>bait fish
You don't have that.

* * *

>e
Nile Riverbank
You are at the bank of the Nile.

You can see a catfish here.

>take catfish
The catfish is swimming freely in the Nile. Maybe you could try fishing for it.

>i
You are carrying:
  a knife
  a fishing rod
  some bait

>eat catfish
You look at it with immense distrust. It just looks so awfully... fishy... Better not.

>i
You are carrying:
  a knife
  a fishing rod
  some bait

>kill catfish
Violence isn't the answer to this one.

>fish
You must supply a noun.

>fish catfish
I only understood you as far as wanting to fish.

>fish
You must supply a noun.

* * *

>take head
Taken.

>i
You are carrying nothing.

>talk to Osiris
I didn't understand that sentence.

>talk to head
I didn't understand that sentence.

>take out head
I only understood you as far as wanting to take outside.

>take head
You already have that.

* * *

>take head
Taken.

>talk to osiri
You can't see any such thing.

>talk to osiris
Hi, there," you say confidently.

Sunset is at 8:22 PM this evening.

>talk to osiris
Hi, there," you say confidently.

boop1

>talk to osiris
Hi, there," you say confidently.

boop2

>talk to osiris
Hi, there," you say confidently.

boop2

>talk to osiris
Hi, there," you say confidently.

Lucy wears a size 9 shoe.

>talk to osiris
Hi, there," you say confidently.

Sunset is at 8:22 PM this evening.

* * *

>take head
Taken.

>talk to osiris
You can't see any such thing.

* * *

>hi
I didn't understand that sentence.

* * *

>ls
I didn't understand that sentence.

>i
You are carrying nothing.

>take catfish
Taken.

>k
I didn't understand that sentence.

>i
You are carrying:
  a catfish
    Osiris' penis

* * *

>kill catfish
Violence isn't the answer to this one.

* * *

>talk to Osiris
I didn't understand that sentence.

* * *

>talk to head
I didn't understand that sentence.

>take heae
You can't see any such thing.

>take head
I don't suppose Osiris' head would care for that.

* * *

>talk to head
Hi, there," you say confidently.

"What's happening?" he replies casually.

>take head
Taken.

>talk to head
Hi, there," you say confidently.

"What's happening?" he replies casually.

>i
You are carrying:
  Osiris' head

* * *

>talk to osiris
You can't see any such thing.

>talk to head
Hi, there," you say confidently.

"What's happening?" he replies casually.

* * *

>talk to osiris
You can't see any such thing.

>test abydos
(first moving to Gate to the Oseiron)

(Testing.)

>[1] s

Descending Passage
A long descending passage. Down south is a great hall. North is the gate.

>[2] s

Great Hall
South is a small chamber. North is the long descending passage.

>[3] e

First Transverse Chamber

>[4] e

Doorway to the Oseiron
To your east you see the central hall, grand and collonaded. However, surrounding the entire central hall island is a moat, preventing you from continuing through.

You can see a sun disk key here.

>take key
Taken.

* * *

>e
Tomb of Osiris
You can see Osiris' head here.

>take head
Taken.

>talk to head
"Osiris," you demanded expectantly. 

Lucy wears a size 9 shoe.

>drop head
Dropped.

>talk to headj
You can't see any such thing.

>talk to head
"Osiris," you demanded expectantly. 

Lucy wears a size 9 shoe.

>i
You are carrying:
  a sun disk key

>talk to head
"Osiris," you demanded expectantly. 

Sunset is at 8:22 PM this evening.

* * *

>test
>--> The following tests are available:
'test abydos'
'test amarna'
'test fish'

>test fish
(first moving to Oxyrhynchos-Marketplace)

(Testing.)

>[1] take rod
Taken.

Your sun chariot is parked at Oxyrhynchos-Marketplace, fiercely guarded by your pet serpents.

>[2] take knife
Taken.

>[3] take bait
Taken.

>[4] bait rod
You attach the bait carefully to the fishing rod.

>[5] e

Nile Riverbank
You are at the bank of the Nile. (like kind of, it's a natural offshoot, now called the yussuf bahr canal or something) West of you is the marketplace.

You can see ten fish (closed) here.

>fish
You cast your fishing rod out with a strong throw...

You have caught a mormyrid.

>i
You are carrying:
  a fish
  a knife
  a fishing rod with bait

>fish
You cast your fishing rod out with a strong throw...

You have caught a mormyrid.

* * *

>i
You are carrying:
  a fish
  a knife
  a fishing rod with bait

>fish
You cast your fishing rod out with a strong throw...

You have caught the catfish!

>i
You are carrying:
  a catfish
  a fish
  a knife
  a fishing rod with bait

>cut fish
(the fish)
You slash the fish with the knife.

Visible within is a Fish guts.

* * *

>test aby
>--> The following tests are available:
'test abydos'
'test fish'

>test abydos
(first moving to Gate to the Oseiron)

(Testing.)

>[1] s

Descending Passage
A long descending passage. Down south is a great hall. North is the gate.

>[2] s

Great Hall
South is a small chamber. North is the long descending passage.

>[3] e

First Transverse Chamber

>[4] e

Doorway to the Oseiron
To your east you see the central hall, grand and collonaded. However, surrounding the entire central hall island is a moat, preventing you from continuing through.

You can see a sun disk key here.

* * *

>e
The golden sun disk in your possession begins to glow brightly, and a radiant bridge of light forms across the dark waters. With the way now open, you step forward.

Central Nave
You stand in the middle of the columns lining the central nave and look around. Surrounding you are 17 small cells. Most of them are shrouded in darkness and you could barely see inside, but one directly east of you seems to lead out to a bigger chamber. The doorway back to the first transverse chamber is to your west.

>drop key
Dropped.

>e
Tomb of Osiris
You can see Osiris' head here.

>w
You approach the edge of the moat, but there is no way across. The waters churn ominously, as if warning you to stay back.

>w
You approach the edge of the moat, but there is no way across. The waters churn ominously, as if warning you to stay back.

>talk to osiris
Osiris. 

boop2

>i
You are carrying nothing.

>i
You are carrying nothing.

>talk to me
There is no reply.

* * *

>test abydos
(first moving to First Transverse Chamber)

(first acquiring the faience ankh)
(first acquiring the wooden plank)
(Testing.)

>[1] e
You place the wood plank down, desperately hoping it'll bear your weight.

Central Nave
You stand in the middle of the columns lining the central nave and look around. Surrounding you are 17 small cells. Most of them are shrouded in darkness and you could barely see inside, but one directly east of you seems to lead out to a bigger chamber. The doorway back to the first transverse chamber is to your west. The ceiling echoes the structure of a sarcophagus. A large statue dominates the center of the room, its scale representative of what could have nly been a god. In front of it, a low altar sits, its surface decorated with scarce items. 

A moat surrounds the entire central nave.

A moat surrounds the entire central nave.

You can also see a statue of Osiris and an altar here.

I beg your pardon?

>w
You place the wood plank down, desperately hoping it'll bear your weight.

First Transverse Chamber
To your east you see the central hall, grand and collonaded. However, surrounding the entire central hall island is a moat, preventing you from continuing through.

A moat surrounds the entire central nave.

You can also see a sun disk key here.

>w
Great Hall
South is a small chamber. North is the long descending passage. East is the first transverse chamber.

>e
First Transverse Chamber
To your east you see the central hall, grand and collonaded. However, surrounding the entire central hall island is a moat, preventing you from continuing through.

A moat surrounds the entire central nave.

You can also see a sun disk key here.

>e
You place the wood plank down, desperately hoping it'll bear your weight.

Central Nave
You stand in the middle of the columns lining the central nave and look around. Surrounding you are 17 small cells. Most of them are shrouded in darkness and you could barely see inside, but one directly east of you seems to lead out to a bigger chamber. The doorway back to the first transverse chamber is to your west. The ceiling echoes the structure of a sarcophagus. A large statue dominates the center of the room, its scale representative of what could have nly been a god. In front of it, a low altar sits, its surface decorated with scarce items. 

A moat surrounds the entire central nave.

A moat surrounds the entire central nave.

You can also see a statue of Osiris and an altar here.

>e
You place the wood plank down, desperately hoping it'll bear your weight.

Tomb of Osiris
The roof and walls has Nut and Geb stuff on it. At the center of the room is a sarcophagus, its wooden frame lavishly painted in the style of the New Kingdom. Comedically, it is wrapped in an almost absurd number of golden chains, as if to guard against any attempt to disturb its occupant.

A moat surrounds the entire central nave.

>i
You are carrying:
  a wooden plank

>x sarcophagus
You can't see any such thing.

>x sarcophagus
You can't see any such thing.

* * *

>e
You place the wood plank down, desperately hoping it'll bear your weight.

Tomb of Osiris
The roof and walls has Nut and Geb stuff on it. At the center of the room is a sarcophagus, its wooden frame lavishly painted in the style of the New Kingdom. Comedically, it is wrapped in an almost absurd number of golden chains, as if to guard against any attempt to disturb its occupant.

A moat surrounds the entire central nave.

You can also see a sarcophagus (closed) here.

>e
triggered
Tomb of Osiris

>w
The golden sun disk in your possession begins to glow brightly, and a radiant bridge of light forms across the dark waters. With the way now open, you step forward.

Central Nave

>n
With the moat surrounding the central nave, it's a struggle to go anywhere.

>n
With the moat surrounding the central nave, it's a struggle to go anywhere.

* * *

>e
You place the wood plank down, desperately hoping it'll bear your weight.

Tomb of Osiris
The roof and walls has Nut and Geb stuff on it. At the center of the room is a sarcophagus, its wooden frame lavishly painted in the style of the New Kingdom. Comedically, it is wrapped in an almost absurd number of golden chains, as if to guard against any attempt to disturb its occupant.

A moat surrounds the entire central nave.

You can also see a sarcophagus (closed) here.

>n
You can't go that way.

>n
You can't go that way.

>go
You'll have to say which compass direction to go in.

>go n
You can't go that way.

* * *

>e
You place the wood plank down, desperately hoping it'll bear your weight.

Tomb of Osiris
The roof and walls has Nut and Geb stuff on it. At the center of the room is a sarcophagus, its wooden frame lavishly painted in the style of the New Kingdom. Comedically, it is wrapped in an almost absurd number of golden chains, as if to guard against any attempt to disturb its occupant.

A moat surrounds the entire central nave.

You can also see a sarcophagus (closed) here.

>open sarcophagus
It seems to be locked.

>open sarcophagus with key
You can't see any such thing.

>open sarcophagus with ankh
You unlock the sarcophagus.

>open sarcophagus
You open the sarcophagus, revealing Osiris' head.

>take head
Taken.

>i
You are carrying:
  Osiris' head
  a wooden plank
  a faience ankh

>sx head
I didn't understand that sentence.

>x head
You see nothing special about Osiris' head.

* * *

>e
You place the wood plank down, desperately hoping it'll bear your weight.

Tomb of Osiris
The roof and walls has Nut and Geb stuff on it. At the center of the room is a sarcophagus, its wooden frame lavishly painted in the style of the New Kingdom. Comedically, it is wrapped in an almost absurd number of golden chains, as if to guard against any attempt to disturb its occupant.

A moat surrounds the entire central nave.

You can also see a sarcophagus (closed) here.

>s
You can't go that way.

>n
You can't go that way.

>e
Tomb of Osiris

>w
The golden sun disk in your possession begins to glow brightly, and a radiant bridge of light forms across the dark waters. With the way now open, you step forward.

Central Nave

* * *

>e
You place the wood plank down, desperately hoping it'll bear your weight.

Tomb of Osiris
The roof and walls has Nut and Geb stuff on it. At the center of the room is a sarcophagus, its wooden frame lavishly painted in the style of the New Kingdom. Comedically, it is wrapped in an almost absurd number of golden chains, as if to guard against any attempt to disturb its occupant.

A moat surrounds the entire central nave.

You can also see a sarcophagus (closed) here.

>w
Doorway to the Oseiron
To your east you see the central hall, grand and collonaded. However, surrounding the entire central hall island is a moat, preventing you from continuing through.

>e
The golden sun disk in your possession begins to glow brightly, and a radiant bridge of light forms across the dark waters. With the way now open, you step forward.

Central Nave

>w
Doorway to the Oseiron
To your east you see the central hall, grand and collonaded. However, surrounding the entire central hall island is a moat, preventing you from continuing through.

* * *

>e
The golden sun disk in your possession begins to glow brightly, and a radiant bridge of light forms across the dark waters. With the way now open, you step forward.

Central Nave

>e
Tomb of Osiris

* * *

>w
The golden sun disk in your possession begins to glow brightly, and a radiant bridge of light forms across the dark waters. With the way now open, you step forward.

Central Nave

>i
You are carrying:
  a sun disk key

>n
You can't go that way.

>go eatr
You can't see any such thing.

>go east
Tomb of Osiris

>go west
The golden sun disk in your possession begins to glow brightly, and a radiant bridge of light forms across the dark waters. With the way now open, you step forward.

Central Nave

>go north
You can't go that way.

* * *

>e
You place the wood plank down, desperately hoping it'll bear your weight.

Tomb of Osiris
The roof and walls has Nut and Geb stuff on it. At the center of the room is a sarcophagus, its wooden frame lavishly painted in the style of the New Kingdom. Comedically, it is wrapped in an almost absurd number of golden chains, as if to guard against any attempt to disturb its occupant.

A moat surrounds the entire central nave.

You can also see a sarcophagus (closed) here.

>x
(the wooden plank)
A short, splintered plank of cedar wood lies on the floor.

>look
First Transverse Chamber
To your east you see the central hall, grand and collonaded. However, surrounding the entire central hall island is a moat, preventing you from continuing through.

A moat surrounds the entire central nave.

You can also see a sun disk key here.

>i
You are carrying:
  a wooden plank

>unlock moat
(with the wooden plank)
You unlock the west moat.

>e
You approach the edge of the moat, but there is no way across. The waters churn ominously, as if warning you to stay back.

>x moat
Deep and murky.

* * *

>n
Gate to the Oseiron
The doorway to the temple tands before you, an unassuming looking side door. It was sturdy and made of good material, but seems to be lightly trafficked. It was even unguarded.

>x door
The heavy stone door is engraved with an ancient riddle: 
 "I am yesterday, veiled in shadows. 
 I am tomorrw, cloaked in flames. 
 A union of gods, a cycle complete."

>n
Abydos-Marketplace
Your sun chariot is parked at Abydos-Marketplace, fiercely guarded by your pet serpents.

>s
Gate to the Oseiron
The doorway to the temple tands before you, an unassuming looking side door. It was sturdy and made of good material, but seems to be lightly trafficked. It was even unguarded.

>e
(first opening the stone door)
It seems to be locked.

* * *

>say sun
(to the stone door)
As you speak the word "stone door," the massive stone door grinds open, revealing the temple's interior.

>s
descending passage
A long descending passage. Down south is a great hall. North is the gate.

* * *

>e
You can't go that way.

>d
You can't go that way.

>s
Great Hall
South is a small chamber. North is the long descending passage.

>n
descending passage
A long descending passage. Down south is a great hall. North is the gate.

>n
Gate to the Oseiron
The doorway to the temple tands before you, an unassuming looking side door. It was sturdy and made of good material, but seems to be lightly trafficked. It was even unguarded.

>enter door
descending passage
A long descending passage. Down south is a great hall. North is the gate.

* * *

>take key
Taken.

* * *

>take head
Taken.

>talk to osiris
"Osiris," you demanded expectantly. 

"boop2" was the only response you got.

>say hi
(to Osiris' head)
There is no reply.

>say waht do you want to osiris
There is no reply.

>i dont know
I only understood you as far as wanting to take inventory.

>"i don't know"
I didn't understand that sentence.

>say "hi"
(to Osiris' head)
There is no reply.

>say alkdshfjskdnf
(to Osiris' head)
There is no reply.

>say hjklkbljnkasdarhwben eahfsdf
(to Osiris' head)
There is no reply.

* * *

>take plank
You can't see any such thing.

>i
You are carrying nothing.

>w
You cross the precarious wood plank again.

First Transverse Chamber
To your east you see the central hall, grand and collonaded. However, surrounding the entire central hall island is a moat, preventing you from continuing through.

A moat surrounds the entire central nave.

You can also see a sun disk key here.

>tkae plank
I didn't understand that sentence.

>take plank
You can't see any such thing.

* * *

>w
You cross the precarious wood plank again.

First Transverse Chamber
To your east you see the central hall, grand and collonaded. However, surrounding the entire central hall island is a moat, preventing you from continuing through.

A moat surrounds the entire central nave.

You can also see a sun disk key here.

>e
You cross the precarious wood plank again.

Central Nave
You stand in the middle of the columns lining the central nave and look around. Surrounding you are 17 small cells. Most of them are shrouded in darkness and you could barely see inside, but one directly east of you seems to lead out to a bigger chamber. The doorway back to the first transverse chamber is to your west. The ceiling echoes the structure of a sarcophagus. A large statue dominates the center of the room, its scale representative of what could have nly been a god. In front of it, a low altar sits, its surface decorated with scarce items. 

A moat surrounds the entire central nave.

A moat surrounds the entire central nave.

You can also see a statue of Osiris and an altar here.

>take plank
You can't see any such thing.

>take
What do you want to take?

* * *

>take
What do you want to take?

* * *

>hello
I didn't understand that sentence.

>guys
I didn't understand that sentence.

>why
I didn't understand that sentence.

>kill me
Violence isn't the answer to this one.

* * *

>w
You place the wood plank down, desperately hoping it'll bear your weight.

First Transverse Chamber
To your east you see the central hall, grand and collonaded. However, surrounding the entire central hall island is a moat, preventing you from continuing through.

A moat surrounds the entire central nave.

You can also see a sun disk key here.

>e
You place the wood plank down, desperately hoping it'll bear your weight.

Central Nave
You stand in the middle of the columns lining the central nave and look around. Surrounding you are 17 small cells. Most of them are shrouded in darkness and you could barely see inside, but one directly east of you seems to lead out to a bigger chamber. The doorway back to the first transverse chamber is to your west. The ceiling echoes the structure of a sarcophagus. A large statue dominates the center of the room, its scale representative of what could have nly been a god. In front of it, a low altar sits, its surface decorated with scarce items. 

A moat surrounds the entire central nave.

A moat surrounds the entire central nave.

You can also see a statue of Osiris and an altar here.

>x
(the wooden plank)
A short, splintered plank of cedar wood lies on the floor.

>x
(the wooden plank)
A short, splintered plank of cedar wood lies on the floor.

>look
Central Nave
You stand in the middle of the columns lining the central nave and look around. Surrounding you are 17 small cells. Most of them are shrouded in darkness and you could barely see inside, but one directly east of you seems to lead out to a bigger chamber. The doorway back to the first transverse chamber is to your west. The ceiling echoes the structure of a sarcophagus. A large statue dominates the center of the room, its scale representative of what could have nly been a god. In front of it, a low altar sits, its surface decorated with scarce items. 

A moat surrounds the entire central nave.

A moat surrounds the entire central nave.

You can also see a statue of Osiris and an altar here.

>i
You are carrying:
  a wooden plank

* * *

>w
You cross the precarious wood plank again.

First Transverse Chamber
To your east you see the central hall, grand and collonaded. However, surrounding the entire central hall island is a moat, preventing you from continuing through.

A moat surrounds the entire central nave.

You can also see a sun disk key here.

>i
You are carrying nothing.

>look
First Transverse Chamber
To your east you see the central hall, grand and collonaded. However, surrounding the entire central hall island is a moat, preventing you from continuing through.

A moat surrounds the entire central nave.

You can also see a sun disk key here.

>e
You cross the precarious wood plank again.

Central Nave
You stand in the middle of the columns lining the central nave and look around. Surrounding you are 17 small cells. Most of them are shrouded in darkness and you could barely see inside, but one directly east of you seems to lead out to a bigger chamber. The doorway back to the first transverse chamber is to your west. The ceiling echoes the structure of a sarcophagus. A large statue dominates the center of the room, its scale representative of what could have nly been a god. In front of it, a low altar sits, its surface decorated with scarce items. 

A moat surrounds the entire central nave.

A moat surrounds the entire central nave.

You can also see a statue of Osiris and an altar here.

>look
Central Nave
You stand in the middle of the columns lining the central nave and look around. Surrounding you are 17 small cells. Most of them are shrouded in darkness and you could barely see inside, but one directly east of you seems to lead out to a bigger chamber. The doorway back to the first transverse chamber is to your west. The ceiling echoes the structure of a sarcophagus. A large statue dominates the center of the room, its scale representative of what could have nly been a god. In front of it, a low altar sits, its surface decorated with scarce items. 

A moat surrounds the entire central nave.

A moat surrounds the entire central nave.

You can also see a statue of Osiris and an altar here.

>i
You are carrying nothing.

* * *

>w
You cross the precarious wood plank again.

First Transverse Chamber
To your east you see the central hall, grand and collonaded. However, surrounding the entire central hall island is a moat, preventing you from continuing through.

A moat surrounds the entire central nave.

You can also see a sun disk key here.

>w
Great Hall
South is a small chamber. North is the long descending passage.

>w
You can't go that way.

>n
descending passage
A long descending passage. Down south is a great hall. North is the gate.

* * *

>x door
The heavy stone door is engraved with an ancient riddle: 
 "I am yesterday, veiled in shadows. 
 I am tomorrw, cloaked in flames. 
 A union of gods, a cycle complete."

>s
descending passage
A long descending passage. Down south is a great hall. North is the gate.

>n
Gate to the Oseiron
The doorway to the temple tands before you, an unassuming looking side door. It was sturdy and made of good material, but seems to be lightly trafficked. It was even unguarded.

* * *

>x
(the sun disk key)
You see nothing special about the sun disk key.

>i
You are carrying:
  a sun disk key

>e
The golden sun disk in your possession begins to glow brightly, and a radiant bridge of light forms across the dark waters. With the way now open, you step forward.

West Moat
The chamber opens to reveal a deep moat, filled with dark, murky water. The far side of the moat, leading to the sacred chamber, is tantalizingly close but utterly inaccessible by normal means.

>e
Central Nave

* * *

>x door
The heavy stone door is engraved with an ancient riddle: 
 "I am yesterday, veiled in shadows. 
 I am tomorrw, cloaked in flames. 
 A union of gods, a cycle complete."

>answer sun to the door
Nothing happens. Perhaps that is not the correct answer.

>say echo to the door
As you speak the word "stone door," the massive stone door grinds open, revealing the temple's interior.

>s
(first opening the stone door)

descending passage
A long descending passage. Down south is a great hall. North is the gate.

* * *

>x statue
Carved from greywacke, it exudes power and authority. Osiris sits on a throne in a mummified form wearing a close-fitting enveloping garment, a divine beard attached to his chin, and the Atef crown flanked by two ostrich feathers, adorned with the uraeus cobra. He holds the royal crook and flail with his arms crossed on his chest. The base of the statue is inscribed with an offering prayer, while the back pillar of the statue is not inscribed. (from the cairo museum, feel free to change) He sure looks put together-- a drastic difference from his current state.

>i
You are carrying:
  a wooden plank
  a faience ankh

>e
You place the wood plank down, desperately hoping it'll bear your weight.

Tomb of Osiris
The roof and walls has Nut and Geb stuff on it. At the center of the room is a sarcophagus, its wooden frame lavishly painted in the style of the New Kingdom. Comedically, it is wrapped in an almost absurd number of golden chains, as if to guard against any attempt to disturb its occupant.

A moat surrounds the entire central nave.

You can also see a sarcophagus (closed) here.

>open sarcophagus with ankh
You unlock the sarcophagus.

* * *

>open sarcophagus
You open the sarcophagus, revealing Osiris' head.

>x head
Osiris, in all his glorious, head-only form.

>take head
Taken.

>test amarna
(Testing.)

>[1] say hi
(to Osiris' head)
There is no reply.

>[2] get on chariot
You can't see any such thing.

>[3] 6
I didn't understand that sentence.

>take head
You already have that.

>look
Tomb of Osiris
The roof and walls has Nut and Geb stuff on it. At the center of the room is a sarcophagus, its wooden frame lavishly painted in the style of the New Kingdom. Comedically, it is wrapped in an almost absurd number of golden chains, as if to guard against any attempt to disturb its occupant.

A moat surrounds the entire central nave.

You can also see a sarcophagus (empty) here.

>e
You can't go that way.

>w
You place the wood plank down, desperately hoping it'll bear your weight.

Central Nave
You stand in the middle of the columns lining the central nave and look around. Surrounding you are 17 small cells. Most of them are shrouded in darkness and you could barely see inside, but one directly east of you seems to lead out to a bigger chamber. The doorway back to the first transverse chamber is to your west. The ceiling echoes the structure of a sarcophagus. A large statue dominates the center of the room, its scale representative of what could have nly been a god. In front of it, a low altar sits, its surface decorated with scarce items. 

A moat surrounds the entire central nave.

A moat surrounds the entire central nave.

You can also see a statue of Osiris and an altar here.

>w
You place the wood plank down, desperately hoping it'll bear your weight.

First Transverse Chamber
To your east you see the central hall, grand and collonaded. However, surrounding the entire central hall island is a moat, preventing you from continuing through.

A moat surrounds the entire central nave.

>w
Great Hall
South is a small chamber. North is the long descending passage. East is the first transverse chamber.

>w
You can't go that way.

>w
You can't go that way.

>wn
I didn't understand that sentence.

>n
descending passage
A long descending passage. Down south is a great hall. North is the gate.

>n
(first opening the stone door)
It seems to be locked.

>n
(first opening the stone door)
It seems to be locked.

* * *

>test amarna
(first moving to Small Aten Temple)

(first acquiring Osiris' head)
(Testing.)

>[1] n

Sanctuary
Unlike sanctuaries in traditional temples, this space is bathed in sunlight, a deliberate design to honor the Aten, the sun disk. Around the perimeter of the sanctuary are low, carved altars, decorated with offerings and incense. In the center of the sanctuary, a shrine depicting Aten seems to shine in its golden splendor. (or something like that i guess)

Arranged delicately atop the altars are offerings of (something). Each item looks fresh, as if newly placed by worshippers -- odd.

>i
You are carrying:
  Osiris' head

Your sun chariot is parked at the Workmen's Village, fiercely guarded by your pet serpents.

I beg your pardon?

>look
Workmen's Village
A dusty cluster of homes and workshops, bustling with activity. The air smells of clay and stone.

You can see a sun chariot and a workman here.

Your sun chariot is parked at the Workmen's Village, fiercely guarded by your pet serpents.

>n
You can't go that way.

Your sun chariot is parked at the Workmen's Village, fiercely guarded by your pet serpents.

>e
The workman's directions lead you to a small, ruined temple. Something about its quiet eeriness feels out of place.

Small Aten Temple
A partially reconstructed temple dedicated to the Aten. Sunlight streams through its ruined walls, illuminating faded murals.

>w
Workmen's Village
A dusty cluster of homes and workshops, bustling with activity. The air smells of clay and stone.

You can see a sun chariot and a workman here.

Your sun chariot is parked at the Workmen's Village, fiercely guarded by your pet serpents.

>talk to workman
There is no reply.

Your sun chariot is parked at the Workmen's Village, fiercely guarded by your pet serpents.

>scene
I didn't understand that sentence.

>SCENE
I didn't understand that sentence.

I beg your pardon?

>list of happening scenes
I didn't understand that sentence.

>SCENES
Scene 'Entire Game' playing (for 6 mins now)
(Scene monitoring now switched on. Type "scenes off" to switch it off again.)

* * *

>test amarna
(first moving to Small Aten Temple)

(first acquiring Osiris' head)
(Testing.)

>[1] n

Sanctuary
Unlike sanctuaries in traditional temples, this space is bathed in sunlight, a deliberate design to honor the Aten, the sun disk. Around the perimeter of the sanctuary are low, carved altars, decorated with offerings and incense. In the center of the sanctuary, a shrine depicting Aten seems to shine in its golden splendor. (or something like that i guess)

Arranged delicately atop the altars are offerings of (something). Each item looks fresh, as if newly placed by worshippers -- odd.

>look
Sanctuary
Unlike sanctuaries in traditional temples, this space is bathed in sunlight, a deliberate design to honor the Aten, the sun disk. Around the perimeter of the sanctuary are low, carved altars, decorated with offerings and incense. In the center of the sanctuary, a shrine depicting Aten seems to shine in its golden splendor. (or something like that i guess)

Arranged delicately atop the altars are offerings of (something). Each item looks fresh, as if newly placed by worshippers -- odd.

>x shrine
(description of shrine, pick object?)
You hear an odd rumbling noise. (here the hidden staircase is revealed).

(description of shrine, pick object?)

>look
Sanctuary
Unlike sanctuaries in traditional temples, this space is bathed in sunlight, a deliberate design to honor the Aten, the sun disk. Around the perimeter of the sanctuary are low, carved altars, decorated with offerings and incense. In the center of the sanctuary, a shrine depicting Aten seems to shine in its golden splendor. (or something like that i guess)

Arranged delicately atop the altars are offerings of (something). Each item looks fresh, as if newly placed by worshippers -- odd.

>w
You can't go that way.

>s
Small Aten Temple
Despite being the smaller Aten Temple, you could still see the foundations that stretched far. It was made of three courts, the first, second, and sanctuary court. You are standing in what used to be the sanctuary court, now demolished into nothingness. A partially reconstructed sanctuary stands before you. It looked glorious, despite being only a fraction of what would've once been there. 

You can see a hidden staircase here.

>enter staircase
Underground chapel
The air is cool and still. Strange elongated statues and murals with eerily etched toes line the walls.

You can see a hidden staircase here.

>look
Underground chapel
The air is cool and still. Strange elongated statues and murals with eerily etched toes line the walls.

You can see a hidden staircase here.

>x statue
Which do you mean, the first statue, the second statue or the third statue?

>x first statue
this is a broken statue. this probably used to be depicting a person. guess we'll never find out.

>touch east mural
*** Run-time problem P23: Attempt to look up a non-existent entry at column 2, row 1 of the table 'Table of Current Sequence'.

That doesn't seem to be the right item to touch right now.

You feel nothing unexpected.

* * *

>test amarna
(first moving to Small Aten Temple)

(first acquiring Osiris' head)
(Testing.)

>[1] n

Sanctuary
Unlike sanctuaries in traditional temples, this space is bathed in sunlight, a deliberate design to honor the Aten, the sun disk. Around the perimeter of the sanctuary are low, carved altars, decorated with offerings and incense. In the center of the sanctuary, a shrine depicting Aten seems to shine in its golden splendor. (or something like that i guess)

Arranged delicately atop the altars are offerings of (something). Each item looks fresh, as if newly placed by worshippers -- odd.

>s
Outside the Walled Village
You can see an oxcart here.

>e
You can't go that way.

>w
It's a long journey to Amarna City: you'll never make it on foot.

>w
It's a long journey to Amarna City: you'll never make it on foot.

* * *

>get on oxcart
You mount the oxcart.

>go e
You can't go that way.

>go w
You sit on the oxcart and it takes you there.

Ruined City (on the oxcart)
This glorious city, once the capital of Egypt, is nothing but ruins and foundations. In the distance, to the north, you see a small standing structure, sticking out like a sore thumb amongst the desolation.

>e
Outside the Walled Village (on the oxcart)

>w
You sit on the oxcart and it takes you there.

Ruined City (on the oxcart)
This glorious city, once the capital of Egypt, is nothing but ruins and foundations. In the distance, to the north, you see a small standing structure, sticking out like a sore thumb amongst the desolation.

>n
The workman's directions lead you to a small, ruined temple. Something about its quiet eeriness feels out of place.

Small Aten Temple (on the oxcart)
A partially reconstructed temple dedicated to the Aten. Sunlight streams through its ruined walls, illuminating faded murals.

>d
Underground Temple (on the oxcart)
The air is cool and still. Strange elongated statues and murals with eerily etched toes line the walls.

You can see a mural and a brain here.

>get off oxcart
You dismount the oxcart.

Underground Temple
The air is cool and still. Strange elongated statues and murals with eerily etched toes line the walls.

You can see an oxcart, a mural and a brain here.

>u
Small Aten Temple
A partially reconstructed temple dedicated to the Aten. Sunlight streams through its ruined walls, illuminating faded murals.

>s
It's a long journey to Amarna City: you'll never make it on foot.

>s
It's a long journey to Amarna City: you'll never make it on foot.

* * *

>s
Outside the Walled Village
You can see an oxcart here.

>w
Ruined City
This glorious city, once the capital of Egypt, is nothing but ruins and foundations. In the distance, to the north, you see a small standing structure, sticking out like a sore thumb amongst the desolation.

>e
It's a long journey to the village: you'll never make it on foot.

>e
It's a long journey to the village: you'll never make it on foot.

>w
You can't go that way.

* * *

>test amarna
(first moving to Small Aten Temple)

(first acquiring Osiris' head)
(Testing.)

>[1] n

Sanctuary
Unlike sanctuaries in traditional temples, this space is bathed in sunlight, a deliberate design to honor the Aten, the sun disk. Around the perimeter of the sanctuary are low, carved altars, decorated with offerings and incense. In the center of the sanctuary, a shrine depicting Aten seems to shine in its golden splendor. (or something like that i guess)

Arranged delicately atop the altars are offerings of (something). Each item looks fresh, as if newly placed by worshippers -- odd.

>say hi
(to Osiris' head)
There is no reply.

>look
Workmen's Village
A dusty cluster of homes and workshops, bustling with activity. The air smells of clay and stone.

You can see a sun chariot and a workman here.

>talk to workman
The workman gestures around. "This village," he says, "it's where the elite tombs nearby are prepared. Hard work, but someone's got to do it." He looks at you curiously. "What are you doing here, anyway? And good gods, are you pregnant?!"

>talk to workman
The workman looks at you expectantly. "What are you doing here, anyway? And what's up with the stomach?"

>talk to workman
The workman looks at you expectantly. "What are you doing here, anyway? And what's up with the stomach?"

>talk to workman
Maybe try showing him what's hidden under your shirt.

>talk to workman
Maybe try showing him what's hidden under your shirt.

>show head to workman
Hey! I don't know what your whole deal is, but here, it's good manners to keep body parts inside a body bag." He tosses you a body bag.

I beg your pardon?

>i
You are carrying:
  a body bag
  Osiris' head

>put head in body bag
You put Osiris' head into the body bag.

>i
You are carrying:
  a body bag
    Osiris' head

* * *

>test amarna
(first moving to Small Aten Temple)

(first acquiring Osiris' head)
(Testing.)

>[1] n

Sanctuary
Unlike sanctuaries in traditional temples, this space is bathed in sunlight, a deliberate design to honor the Aten, the sun disk. Around the perimeter of the sanctuary are low, carved altars, decorated with offerings and incense. In the center of the sanctuary, a shrine depicting Aten seems to shine in its golden splendor. (or something like that i guess)

Arranged delicately atop the altars are offerings of (something). Each item looks fresh, as if newly placed by worshippers -- odd.

>show head to workman
The workman is unimpressed.

>talk to workman
"Hey you," you called to the workman.  

The workman turns around with a disgruntled expression. "What do you want?" he asks.  

You explain that you're looking for information about the village.  

The workman gestures around. "This village," he says, "it's where the elite tombs nearby are prepared. Hard work, but someone's got to do it." He looks at you curiously. "What are you doing here, anyway? And good gods, are you pregnant?!"

I beg your pardon?

>talk to workman
The workman looks at you expectantly. "What are you doing here, anyway? And what's up with the stomach?"

* * *

>show head to workman
Hey! I don't know what your whole deal is, but here, it's good manners to keep body parts inside a body bag." He tosses you a body bag.

>talk to workman
The workman looks at you with exasperation. "I've told you everything I know. Go to the old Aten temple for you weird heads.

>show head to workman
Flashing a decapitated head to someone you've never talked to may be a bit much. Try striking a conversation first.

* * *

>talk to workman
"Hey you," you called to the workman.  

The workman turns around with a disgruntled expression. "What do you want?" he asks.  

You explain that you're looking for information about the village.  

The workman gestures around. "This village," he says, "it's where the elite tombs nearby are prepared. Hard work, but someone's got to do it." He looks at you curiously. "What are you doing here, anyway? And good gods, are you pregnant?!"

>talk to workman
The workman looks at you expectantly. "What are you doing here, anyway? And what's up with the stomach?"

>show head to workman
You carefully take the head from under your shirt and show it to the workman. "Do you know anything to go along with this?" you ask.

The workman eyes you warily. "You collect heads, huh? Weird. But if you want odd heads, the old Aten cult temple's the place to check. (here, mention more about the cult) "  

You give a curt nod of thanks. Just as you turn to leave, he calls to you. "Hey! I don't know what your whole deal is, but here, it's good manners to keep body parts inside a body bag." He tosses you a body bag.

>say hi to workman
There is no reply.

>talk to workman
The workman looks at you with exasperation. "I've told you everything I know. Go to the old Aten temple for you weird heads.

>leave
But you aren't in anything at the moment.

>i
You are carrying:
  a body bag
  Osiris' head

>show head
What do you want to show Osiris' head?

>workman
(first taking the workman)
I don't suppose the workman would care for that.

>show head to workman
I don't think showing Osiris" head off again is necessary.

* * *

>test amarna
(first moving to Small Aten Temple)

(first acquiring Osiris' head)
(Testing.)

>[1] n

Sanctuary
Unlike sanctuaries in traditional temples, this space is bathed in sunlight, a deliberate design to honor the Aten, the sun disk. Around the perimeter of the sanctuary are low, carved altars, decorated with offerings and incense. In the center of the sanctuary, a shrine depicting Aten seems to shine in its golden splendor. (or something like that i guess)

Arranged delicately atop the altars are offerings of (something). Each item looks fresh, as if newly placed by worshippers -- odd.

>x shrine
(description of shrine, pick object?)
You hear an odd rumbling noise. (here the hidden staircase is revealed).

(description of shrine, pick object?)

>i
You are carrying:
  Osiris' head

>look
Sanctuary
Unlike sanctuaries in traditional temples, this space is bathed in sunlight, a deliberate design to honor the Aten, the sun disk. Around the perimeter of the sanctuary are low, carved altars, decorated with offerings and incense. In the center of the sanctuary, a shrine depicting Aten seems to shine in its golden splendor. (or something like that i guess)

Arranged delicately atop the altars are offerings of (something). Each item looks fresh, as if newly placed by worshippers -- odd.

You can also see a hidden staircase here.

>enter staircase
Underground chapel
The air is cool and still. Strange elongated statues and murals with eerily etched toes line the walls.

You can see a hidden staircase, a north mural, a south mural, an east mural, a west mural and Osiris' brain here.

* * *

>x shrine
(description of shrine, pick object?)
You hear an odd rumbling noise. (here the hidden staircase is revealed).

(description of shrine, pick object?)

>s
Small Aten Temple
Despite being the smaller Aten Temple, you could still see the foundations that stretched far. It was made of three courts, the first, second, and sanctuary court. You are standing in what used to be the sanctuary court, now demolished into nothingness. A partially reconstructed sanctuary stands before you. It looked glorious, despite being only a fraction of what would've once been there. 

You can see a staircase here.

>go down staircase
I only understood you as far as wanting to go down.

>go down
Underground chapel
The air is cool and still. Strange elongated statues and murals with eerily etched toes line the walls.

You can see a staircase here.

>x statue
Which do you mean, the first statue, the second statue or the third statue?

>x east mural
 a weathered relief shows nothing but a round disk in the center. surely etchings used to be around it, but we cant see them.

>touch east mural
You touch the east mural, and something clicks into place.

You feel nothing unexpected.

>touch west mural
That doesn't seem to be the right item to touch right now.

You feel nothing unexpected.

>touch third statue
That doesn't seem to be the right item to touch right now.

You feel nothing unexpected.

>touch east mural
You touch the east mural, and something clicks into place.

You feel nothing unexpected.

>touch north mural
You touch the north mural, and something clicks into place.

You feel nothing unexpected.

>touch third statue
You touch the third statue, and something clicks into place.

You feel nothing unexpected.

>x ceiling
has some hint revealing the sequence in which to touch stuff - for example-- in a laid out sequence, you see the a sun disk, reaching out hand rays, onto the offerings of lotus flowers, held by a person with a very long head.

>touch second statue
You touch the second statue, and something clicks into place.

You feel nothing unexpected.

>up
Small Aten Temple
Despite being the smaller Aten Temple, you could still see the foundations that stretched far. It was made of three courts, the first, second, and sanctuary court. You are standing in what used to be the sanctuary court, now demolished into nothingness. A partially reconstructed sanctuary stands before you. It looked glorious, despite being only a fraction of what would've once been there. 

You can see a staircase here.

>look
Small Aten Temple
Despite being the smaller Aten Temple, you could still see the foundations that stretched far. It was made of three courts, the first, second, and sanctuary court. You are standing in what used to be the sanctuary court, now demolished into nothingness. A partially reconstructed sanctuary stands before you. It looked glorious, despite being only a fraction of what would've once been there. 

You can see a staircase here.

>w
You can't go that way.

* * *

>e
You can't go that way.

>n
Sanctuary
Unlike sanctuaries in traditional temples, this space is bathed in sunlight, a deliberate design to honor the Aten, the sun disk. Around the perimeter of the sanctuary are low, carved altars, decorated with offerings and incense. In the center of the sanctuary, a shrine depicting Aten seems to shine in its golden splendor. (or something like that i guess)

Arranged delicately atop the altars are offerings of (something). Each item looks fresh, as if newly placed by worshippers -- odd.

You can also see Osiris' brain here.

>take brain
Taken.

* * *

>test fish
(first moving to Oxyrhynchos-Marketplace)

(Testing.)

>[1] take rod
Taken.

Your sun chariot is parked at Oxyrhynchos-Marketplace, fiercely guarded by your pet serpents.

>[2] take knife
Taken.

>[3] take bait
Taken.

>[4] bait rod
You attach the bait carefully to the fishing rod.

>[5] e

Nile Riverbank
You are at the bank of the Nile. (like kind of, it's a natural offshoot, now called the yussuf bahr canal or something) West of you is the marketplace.

>fish
You cast your fishing rod out with a strong throw...

You have caught a perch.

>cut fish
(the tigerfish)
You slash the tigerfish with the knife.

Visible within is a fish guts.

* * *

>fish
You cast your fishing rod out with a strong throw...

You have caught a perch.

>fish
You cast your fishing rod out with a strong throw...

You have caught a perch.

>fish
You already have a fish in your posession. Don't be so greedy.

>drop catfish
Dropped.

>fish
You cast your fishing rod out with a strong throw...

You have caught a perch.

>fish
You cast your fishing rod out with a strong throw...

You have caught a tilapia.

>i
You are carrying:
  a Fish
  a knife
  a fishing rod with bait

>fish
You cast your fishing rod out with a strong throw...

You have caught a perch.

>look
Nile Riverbank
You are at the bank of the Nile. (like kind of, it's a natural offshoot, now called the yussuf bahr canal or something) West of you is the marketplace.

You can see a catfish and nine fish (closed) here.

>i
You are carrying:
  a Fish
  a knife
  a fishing rod with bait

* * *

>fish
You cast your fishing rod out with a strong throw...

You have caught a perch.

>i
You are carrying:
  a Fish
  a knife
  a fishing rod with bait

* * *

>fish
You already have a fish in your posession. Don't be so greedy.

>fish
You cast your fishing rod out with a strong throw...

>fish
You cast your fishing rod out with a strong throw...

>fish
You cast your fishing rod out with a strong throw...

You have caught the catfish!

* * *

>fish
You cast your fishing rod out with a strong throw...

>take penis
You can't see any such thing.

>x catfish
It's a catfish... I wonder if that has any significance?

>take penis
You can't see any such thing.

>cut fish
You slash the catfish with the knife.

Visible within is Osiris' penis.

>take penis
Taken.

>i
You are carrying:
  Osiris' penis
  a catfish
  a knife
  a fishing rod

* * *

>fish
You cast your fishing rod out with a strong throw...

>x fish
 It's a catfish... I wonder if that has any significance?

>fish
You cast your fishing rod out with a strong throw...

You missed the fish!

* * *

>fish
You cast your fishing rod out with a strong throw...

You have caught the catfish!

>x fish
  You look it in the eyes with great suspicion. It looks back at you, and reveals nothing. But maybe its silence can be resolved by a good gutting.

>gut fish
What do you want to gut the catfish with?

>gut fish with blade
You can't see any such thing.

>gut fish with knife
You slash the catfish with the knife.

Visible within is Osiris' penis.

>x fish
  You look it in the eyes with great suspicion. It looks back at you, and reveals nothing. But maybe its silence can be resolved by a good gutting.

You see one rip in the catfish, revealing Osiris' penis.

* * *

>fish
You already have a fish in your posession. Don't be so greedy.

>gut fish
What do you want to gut the catfish with?

>gut fish with knife
You slash the catfish with the knife.

Visible within is Osiris' penis.

* * *

>fish
You already have a fish in your posession. Don't be so greedy.

>x fish
  You eye the catfish with great suspicion. It looks back at you and reveals nothing. Maybe its silence can be resolved by a good gutting.

>cut fish
You slash the catfish with the knife.

Visible within is Osiris' penis.

>x fish
 

You see one rip in the catfish, revealing Osiris' penis.

>x fish
 

You see one rip in the catfish, revealing Osiris' penis.

>take penis
Taken.

* * *

>i
You are carrying:
  Osiris' penis
  a catfish
  a knife
  a fishing rod

>drop catfish
Dropped.

>x
What do you want to examine?

>x catfish
 It's a catfish... I wonder if that has any significance?  

You see one rip in the catfish.

* * *

>fish
You cast your fishing rod out with a strong throw...

You have caught a perch.

>i
You are carrying:
  a perch
  a knife
  a fishing rod with bait

>fish
You cast your fishing rod out with a strong throw...

You have caught a tilapia.

>i
You are carrying:
  a tilapia
  a knife
  a fishing rod with bait

* * *

>fish
You cast your fishing rod out with a strong throw...

You have caught a perch.

>kill fish
Violence isn't the answer to this one.

>x fish
It's a catfish... I wonder if that has any significance?

>gut fish
What do you want to gut the catfish with?

>cut fish
You slash the catfish with the knife.

Visible within is Osiris' penis.

* * *

>fish
You cast your fishing rod out with a strong throw...

You have caught a perch.

>i
You are carrying:
  a tigerfish
  a knife
  a fishing rod with bait

>cut fish
(the fish)
You slash the fish with the knife.

Visible within is a Fish guts.

>i
You are carrying:
  a fish
    a Fish guts
  a knife
  a fishing rod with bait

>fish
You cast your fishing rod out with a strong throw...

You have caught a perch.

>i
You are carrying:
  a fish
    a Fish guts
  a knife
  a fishing rod with bait

>i
You are carrying:
  a fish
    a Fish guts
  a knife
  a fishing rod with bait

>look
Nile Riverbank
You are at the bank of the Nile. (like kind of, it's a natural offshoot, now called the yussuf bahr canal or something) West of you is the marketplace.

You can see nine fish (closed) here.

>drop fish
(the fish)
You drop the fish. It makes a valiant leap for the river and succeeds! It swims away aggressively.

>i
You are carrying:
  a knife
  a fishing rod with bait

>look
Nile Riverbank
You are at the bank of the Nile. (like kind of, it's a natural offshoot, now called the yussuf bahr canal or something) West of you is the marketplace.

You can see nine fish (closed) here.

>fish
You cast your fishing rod out with a strong throw...

You have caught a tigerfish.

>i
You are carrying:
  a fish
    a Fish guts
  a knife
  a fishing rod with bait

* * *

>look
Nile Riverbank
You are at the bank of the Nile. (like kind of, it's a natural offshoot, now called the yussuf bahr canal or something) West of you is the marketplace.

You can see nine fish (closed) here.

>look
Nile Riverbank
You are at the bank of the Nile. (like kind of, it's a natural offshoot, now called the yussuf bahr canal or something) West of you is the marketplace.

You can see nine fish (closed) here.

* * *

>i
You are carrying:
  a tigerfish
  a knife
  a fishing rod with bait

>fish
You cast your fishing rod out with a strong throw...

You have caught a mormyrid.

>i
You are carrying:
  a mormyrid
  a knife
  a fishing rod with bait

>fish
You cast your fishing rod out with a strong throw...

You have caught a perch.

>fish
You cast your fishing rod out with a strong throw...

You have caught a tigerfish.

>fish
You cast your fishing rod out with a strong throw...

You have caught a mormyrid.

>fish
You cast your fishing rod out with a strong throw...

You have caught a mormyrid.

>fish
You cast your fishing rod out with a strong throw...

You have caught the catfish!

>i
You are carrying:
  a catfish
  a mormyrid
  a knife
  a fishing rod with bait

>cut catfish
You slash the catfish with the knife.

Visible within is Osiris' penis.

>cut catfish
You slash the catfish with the knife.

Visible within is Osiris' penis.

>i
You are carrying:
  a catfish
    Osiris' penis
  a mormyrid
  a knife
  a fishing rod with bait

>x catfish
 

You see two rips in the catfish, revealing Osiris' penis.

>fish
You cast your fishing rod out with a strong throw...

You have caught a perch.

>x perch
A fish.

* * *

>fish
You cast your fishing rod out with a strong throw...

You have caught a perch.

>i
You are carrying:
  a perch
  a catfish
  a knife
  a fishing rod with bait

>look
Nile Riverbank
You are at the bank of the Nile. (like kind of, it's a natural offshoot, now called the yussuf bahr canal or something) West of you is the marketplace.

You can see nine fish (closed) here.

>drop perch
You drop the fish. It makes a valiant leap for the river and succeeds! It swims away aggressively.

>i
You are carrying:
  a catfish
  a knife
  a fishing rod with bait

>look
Nile Riverbank
You are at the bank of the Nile. (like kind of, it's a natural offshoot, now called the yussuf bahr canal or something) West of you is the marketplace.

You can see nine fish (closed) here.

>fish
You cast your fishing rod out with a strong throw...

You have caught the catfish!

>fish
You cast your fishing rod out with a strong throw...

You have caught the catfish!

>fish
You cast your fishing rod out with a strong throw...

You have caught a mormyrid.

>i
You are carrying:
  a mormyrid
  a catfish
  a knife
  a fishing rod with bait

>drop fish
(the mormyrid)
You drop the fish. It makes a valiant leap for the river and succeeds! It swims away aggressively.

>drop catfish
Dropped.

>i
You are carrying:
  a knife
  a fishing rod with bait

>look
Nile Riverbank
You are at the bank of the Nile. (like kind of, it's a natural offshoot, now called the yussuf bahr canal or something) West of you is the marketplace.

You can see a catfish and nine fish (closed) here.

>fish
You cast your fishing rod out with a strong throw...

You have caught a tilapia.

* * *

>i
You are carrying:
  a tilapia
  a knife
  a fishing rod with bait

>cut fish
You slash the tilapia with the knife.

Visible within is a fish guts.

>i
You are carrying:
  a tilapia
    a fish guts
  a knife
  a fishing rod with bait

>look
Nile Riverbank
You are at the bank of the Nile. (like kind of, it's a natural offshoot, now called the yussuf bahr canal or something) West of you is the marketplace.

You can see a catfish and nine fish (closed) here.

>fish
You cast your fishing rod out with a strong throw...

You have caught a perch.

>i
You are carrying:
  a perch
    a fish guts
  a knife
  a fishing rod with bait

* * *

>fish
You cast your fishing rod out with a strong throw...

You have caught a perch.

>w
Oxyrhynchus
You are in Oxyrhynchus, home of the medjed elephantfish. A little further east is the riverbank of the Nile.

>fish
You have caught the catfish! Sadly, you can only carry one at a time.

* * *

>test fish
(first moving to Oxyrhynchos-Marketplace)

(Testing.)

>[1] take rod
Taken.

Your sun chariot is parked at Oxyrhynchos-Marketplace, fiercely guarded by your pet serpents.

>[2] take knife
Taken.

>[3] take bait
Taken.

>[4] bait rod
You attach the bait carefully to the fishing rod.

>[5] e

Nile Riverbank
You are at the bank of the Nile. (like kind of, it's a natural offshoot, now called the yussuf bahr canal or something) West of you is the marketplace.

>look
Nile Riverbank
You are at the bank of the Nile. (like kind of, it's a natural offshoot, now called the yussuf bahr canal or something) West of you is the marketplace.

You can see many fish here.

>x fish
You see nothing special about many fish.

* * *

>test fish
(first moving to Oxyrhynchos-Marketplace)

(Testing.)

>[1] take rod
Taken.

Your sun chariot is parked at Oxyrhynchos-Marketplace, fiercely guarded by your pet serpents.

>[2] take knife
Taken.

>[3] take bait
Taken.

>[4] bait rod
You attach the bait carefully to the fishing rod.

>[5] e

Nile Riverbank
You are at the bank of the Nile. (like kind of, it's a natural offshoot, now called the yussuf bahr canal or something) West of you is the marketplace.

>x fish
You see nothing special about many fish.

>take fish
Taken.

>i
You are carrying:
  many fish
  a knife
  a fishing rod with bait

* * *

>think
What a good idea.

>think about trees
I only understood you as far as wanting to think.

* * *

>x book
It is entitled Why Not To Take A Stuffed Bear, A Chocolate Cookie And A Book To The Moon.

>n
You can't go that way.

>n book
I only understood you as far as wanting to (go) north.

>n
You can't go that way.

>actions
Actions listing on.

>n
[going north]
You can't go that way.
[going north - failed the can't go that way rule]

>x
What do you want to examine?

>x book
[examining the book]
It is entitled Why Not To Take A Stuffed Bear, A Chocolate Cookie And A Book To The Moon.

[examining the book - succeeded]

>actions
Actions listing on.

>actions off
Actions listing off.

* * *

>x catfish
You see nothing special about the catfish.

>fish catfish
I only understood you as far as wanting to fish.

>fish
You've got nothing to fish with. Your hands won't suffice, unfortunately.
It probably won't be very productive without any bait.

You cast the baited fishing pole into the river and wait patiently...
After a few moments, you feel a tug and pull up a large catfish!

>i
You are carrying:
  a catfish

>cut
(the catfish)
Your fingernails are not sharp enough.

* * *

>x catfish
You see nothing special about the catfish.

>take penis from catfish
Taken.

* * *

>x door
The heavy stone door is engraved with an ancient riddle: 
 "I am yesterday, veiled in shadows. 
 I am tomorrw, cloaked in flames. 
 A union of gods, a cycle complete."

>say sun
(to the stone door)
As you speak the word "sun," the massive stone door grinds open, revealing a long narrow passa

>hello
I didn't understand that sentence.

>enter door
descending passage
A long descending passage. Down south is a great hall. North is the gate. Easet is the first transverse chamber.

>e
You can't go that way.

>e
You can't go that way.

>s
Great Hall
South is a small chamber. North is the long descending passage.

* * *

>e
First Transverse Chamber

>look
First Transverse Chamber

>w
Great Hall
South is a small chamber. North is the long descending passage.

>s
South Chamber
The small chamber contains... something? North is the great hall. Mention the things in the room in this description of the room. player can examine for more details.

You can see a faience ankh, a bundle of dried thyme, an ostracon, some pottery jars, a wooden plank and some knick-knacks here.

* * *

>x fish
You can't see any such thing.

>test fish
(first moving to Oxyrhynchus)

(Testing.)

>[1] take all
bait: Taken.
fishing rod: Taken.
knife: Taken.

>[2] bait rod
You attach the bait carefully to the fishing rod.

>[3] e

Nile Riverbank
You are at the bank of the Nile.

You can see a catfish here.

>[4] fish
You cast your fishing rod out with a strong throw...

You missed the fish!

>fish
You cast your fishing rod out with a strong throw...

You have caught the catfish!

>x fish
  You eye the catfish with great suspicion. It looks back at you and reveals nothing. Maybe its silence can be resolved by a good gutting.

* * *

>cut fish
You slash the catfish with the knife.

Visible within is Osiris' penis.

>x fish
  You eye the catfish with great suspicion. It looks back at you and reveals nothing. Maybe its silence can be resolved by a good gutting.

You see one rip in the catfish, revealing Osiris' penis.

>x fish
  You eye the catfish with great suspicion. It looks back at you and reveals nothing. Maybe its silence can be resolved by a good gutting.

You see one rip in the catfish, revealing Osiris' penis.

>i
You are carrying:
  a catfish
    Osiris' penis
  a knife
  a fishing rod

>cut fish
You slash the catfish with the knife.

Visible within is Osiris' penis.

>cut fish
You slash the catfish with the knife.

Visible within is Osiris' penis.

>x fish
  You eye the catfish with great suspicion. It looks back at you and reveals nothing. Maybe its silence can be resolved by a good gutting.

You see three rips in the catfish, revealing Osiris' penis.

* * *

>x fishing rod
 A sturdy fishing rod, but it could use some bait.

>bait fishing rod
You don't have that.

>bait rod
You don't have that.

>take rod
Taken.

>bait rod
You don't have anything to bait it with.

>take bait
Taken.

>take knife
Taken.

>bait knife
You can't bait that.

>bait rod
You attach the bait carefully to the fishing rod.

>x rod
  The fishing pole is now baited with some fish food.

>e
Nile Riverbank
You are at the bank of the Nile.

You can see a catfish here.

* * *

>fish
You have caught the catfish! Sadly, you can only carry one at a time.

>cut fish
You carefully cut open the catfish with the knife. Inside its stomach, you find Osiris" penis!

>w
Oxyrhynchus
You are in Oxyrhynchus, home of the medjed elephantfish.

>f
That's not a verb I recognise.

>fish
You missed the fish!